############################
#@.....................................................#
#...........####.....#..............................#
#....##..........##................................##
#..#.......##..........#.............................#
#..........##..........#............................##
#......##..............................................#
###.................##...............................#
####..........##########..................#
#########...........###.....................#
#..................####..............................#
#######........#####...#...............###
#...........#####..........................#####
#.....#####....###...#.....#..................#
############################